Title,Year,Budget,Revenue,Gross_Revenue,Average_Vote
Toy Story,1995,30000000,373554033,403554033,7.7
Jumanji,1995,65000000,262797249,327797249,6.9
Waiting to Exhale,1995,16000000,81452156,97452156,6.1
Heat,1995,60000000,187436818,247436818,7.7
Sudden Death,1995,35000000,64350171,99350171,5.5
GoldenEye,1995,58000000,352194034,410194034,6.6
The American President,1995,62000000,107879496,169879496,6.5
Nixon,1995,44000000,13681765,57681765,7.1
Cutthroat Island,1995,98000000,10017322,108017322,5.7
Casino,1995,52000000,116112375,168112375,7.8
Sense and Sensibility,1995,16500000,135000000,151500000,7.2
Four Rooms,1995,4000000,4300000,8300000,6.5
Ace Ventura: When Nature Calls,1995,30000000,212385533,242385533,6.1
Money Train,1995,60000000,35431113,95431113,5.4
Get Shorty,1995,30250000,115101622,145351622,6.4
Assassins,1995,50000000,30303072,80303072,6
Leaving Las Vegas,1995,3600000,49800000,53400000,7.1
Now and Then,1995,12000000,27400000,39400000,6.6
The City of Lost Children,1995,18000000,1738611,19738611,7.6
Twelve Monkeys,1995,29500000,168840000,198340000,7.4
Babe,1995,30000000,254134910,284134910,6
Dead Man Walking,1995,11000000,39363635,50363635,7.3
Mortal Kombat,1995,18000000,122195920,140195920,5.4
To Die For,1995,20000000,21284514,41284514,6.7
How To Make An American Quilt,1995,10000000,23574130,33574130,6.5
Se7en,1995,33000000,327311859,360311859,8.1
Pocahontas,1995,55000000,346079773,401079773,6.7
The Usual Suspects,1995,6000000,23341568,29341568,8.1
Mighty Aphrodite,1995,15000000,6700000,21700000,6.7
Friday,1995,3500000,28215918,31715918,7
From Dusk Till Dawn,1996,19000000,25836616,44836616,6.9
Fair Game,1995,50000000,11534477,61534477,4.1
Big Bully,1996,15000000,2042530,17042530,3.9
Screamers,1995,20000000,5781885,25781885,6.1
Things to Do in Denver When You're Dead,1995,8000000,529766,8529766,6.7
White Squall,1996,38000000,10300000,48300000,6.3
Nick of Time,1995,8169363,8175346,16344709,6.1
Mary Reilly,1996,47000000,12379402,59379402,5.7
Vampire in Brooklyn,1995,14000000,19800000,33800000,4.5
Broken Arrow,1996,50000000,150270147,200270147,5.7
Bottle Rocket,1996,7000000,560069,7560069,6.8
Happy Gilmore,1996,12000000,41205099,53205099,6.5
The Bridges of Madison County,1995,24000000,182016617,206016617,7.3
Braveheart,1995,72000000,210000000,282000000,7.7
Rumble in the Bronx,1995,7500000,32392047,39892047,6.5
Steal Big Steal Little,1995,25000000,6278139,31278139,5.1
Boomerang,1992,40000000,70100000,110100000,5.4
Flirting with Disaster,1996,7000000,14702438,21702438,6.3
Jade,1995,50000000,9851610,59851610,5.1
The Birdcage,1996,31000000,185260553,216260553,6.7
Bad Boys,1995,19000000,141407024,160407024,6.5
An Awfully Big Adventure,1995,4000000,851545,4851545,6
Apollo 13,1995,52000000,355237933,407237933,7.3
Rob Roy,1995,28000000,31596911,59596911,6.5
Batman Forever,1995,100000000,336529144,436529144,5.2
Blue in the Face,1995,2000000,1275000,3275000,6.8
Canadian Bacon,1995,11000000,178104,11178104,5.9
Casper,1995,50000000,287928194,337928194,6
Clockers,1995,25000000,13071518,38071518,6.8
Congo,1995,50000000,152022101,202022101,5
Crimson Tide,1995,53000000,157387195,210387195,7
Desperado,1995,7000000,25405445,32405445,6.8
Devil in a Blue Dress,1995,27000000,16140822,43140822,6.3
Die Hard: With a Vengeance,1995,90000000,366101666,456101666,6.9
First Knight,1995,55000000,127600435,182600435,5.9
Hackers,1995,20000000,7563728,27563728,6.2
Johnny Mnemonic,1995,25000000,19075720,44075720,5.5
Judge Dredd,1995,90000000,113493481,203493481,5.4
Kids,1995,1500000,7412216,8912216,6.8
Living in Oblivion,1995,500000,1148752,1648752,7.2
Mallrats,1995,6000000,2122561,8122561,6.8
Mighty Morphin Power Rangers: The Movie,1995,15000000,66000000,81000000,5.2
Mute Witness,1995,2,1,3,6.4
The Net,1995,22000000,110627965,132627965,5.6
Party Girl,1995,150000,472370,622370,5.8
The Prophecy,1995,8,16,24,6.4
The Scarlet Letter,1995,50000000,10382407,60382407,5.5
Showgirls,1995,45000000,20350754,65350754,4.9
Smoke,1995,7000000,8349430,15349430,7.2
Species,1995,35000000,113374103,148374103,5.5
Strange Days,1995,42000000,7959291,49959291,6.8
The Tie That Binds,1995,14000000,5780000,19780000,4.6
Under Siege 2: Dark Territory,1995,60000000,104324083,164324083,5.6
A Walk in the Clouds,1995,20000000,50012507,70012507,6.5
Waterworld,1995,175000000,264218220,439218220,5.9
Burnt by the Sun,1994,2800000,2616503,5416503,6.7
Before Sunrise,1995,2500000,5535405,8035405,7.7
Billy Madison,1995,10000000,26488734,36488734,6.2
Boys on the Side,1995,21000000,23450000,44450000,6.3
Clerks,1994,27000,3151130,3178130,7.4
Don Juan DeMarco,1994,25000000,22200000,47200000,6.3
Disclosure,1994,55000000,214015089,269015089,5.9
Dumb and Dumber,1994,16000000,247275374,263275374,6.5
Ed Wood,1994,18000000,5887457,23887457,7.3
Hideaway,1995,15000000,12201255,27201255,5
Hoop Dreams,1994,700000,7830611,8530611,7.7
Heavenly Creatures,1994,5000000,3049135,8049135,6.9
Houseguest,1995,10500000,26325256,36825256,6
Interview with the Vampire,1994,60000000,223664608,283664608,7.2
Jefferson in Paris,1995,14000000,2474000,16474000,5.2
Junior,1994,60000000,37000000,97000000,4.7
Like Water for Chocolate,1992,2000000,21665468,23665468,6.6
Legends of the Fall,1994,30000000,160638883,190638883,7.2
Losing Isaiah,1995,17000000,7603766,24603766,6.4
Mary Shelley's Frankenstein,1994,45000000,112006296,157006296,6.1
Miami Rhapsody,1995,6,5,11,5.6
Nell,1994,31000000,106683817,137683817,6.1
Natural Born Killers,1994,34000000,50282766,84282766,6.9
Outbreak,1995,50000000,189859560,239859560,6.4
Leon: The Professional,1994,16000000,45284974,61284974,8.2
The Perez Family,1995,11000000,2832826,13832826,6.6
Pulp Fiction,1994,8000000,213928762,221928762,8.3
Pushing Hands,1992,400000,152322,552322,6.1
The Quick and the Dead,1995,32000000,18552460,50552460,6.2
Roommates,1995,22000000,12400000,34400000,6.4
Prêt-à-Porter,1994,15000000,11300653,26300653,5.3
The Swan Princess,1994,35000000,9771658,44771658,6.5
The Specialist,1994,45000000,170362582,215362582,5.5
Stargate,1994,55000000,196567262,251567262,6.8
The Santa Clause,1994,22000000,189833357,211833357,6.3
The Shawshank Redemption,1994,25000000,28341469,53341469,8.5
Tank Girl,1995,25000000,4064495,29064495,5.5
Star Trek: Generations,1994,38000000,120000000,158000000,6.4
Tales from the Hood,1995,6000000,12000000,18000000,5.4
What's Eating Gilbert Grape,1993,11000000,10032765,21032765,7.5
Virtuosity,1995,30000000,24048000,54048000,5.4
While You Were Sleeping,1995,17000000,182057016,199057016,6.5
Muriel's Wedding,1994,3000000,15119639,18119639,6.9
Ace Ventura: Pet Detective,1994,15000000,107217396,122217396,6.4
Bitter Moon,1992,5000000,1862805,6862805,7
Clear and Present Danger,1994,62000000,215887717,277887717,6.4
The Client,1994,45000000,117615211,162615211,6.4
The Crow,1994,15000000,94000000,109000000,7.3
The Flintstones,1994,46000000,341631208,387631208,5
Forrest Gump,1994,55000000,677945399,732945399,8.2
Four Weddings and a Funeral,1994,6000000,254700832,260700832,6.6
I Love Trouble,1994,45000000,61947267,106947267,5.3
The Lion King,1994,45000000,788241776,833241776,8
Little Buddha,1993,35000000,4858139,39858139,6
New Nightmare,1994,14000000,18090181,32090181,6.4
The Mask,1994,23000000,351583407,374583407,6.6
The Naked Gun 33⅓: The Final Insult,1994,30000000,51132598,81132598,6.4
Reality Bites,1994,11500000,20079850,31579850,6.5
Red Rock West,1993,8000000,2000000,10000000,6.4
Speed,1994,30000000,350448145,380448145,6.8
Timecop,1994,27000000,101646581,128646581,5.5
True Lies,1994,115000000,378882411,493882411,6.8
Wyatt Earp,1994,63000000,25052000,88052000,6.5
A Low Down Dirty Shame,1994,10000000,29392418,39392418,6
Jason's Lyric,1994,7000000,20851521,27851521,5.9
Street Fighter,1994,35000000,99423521,134423521,4.1
Highlander: The Final Dimension,1994,26000000,36800000,62800000,4.5
In the Mouth of Madness,1994,8000000,8946600,16946600,7.1
The Age of Innocence,1993,34000000,32255440,66255440,7
The Air Up There,1994,17080000,21011500,38091500,5.1
Beverly Hills Cop III,1994,50000000,119208989,169208989,5.5
Body Snatchers,1993,13000000,428868,13428868,5.8
A Bronx Tale,1993,22000000,17287898,39287898,7.4
Calendar Girl,1993,13000000,2570145,15570145,3.7
Carlito's Way,1993,30000000,36516012,66516012,7.7
Cliffhanger,1993,70000000,255000211,325000211,6.1
Color of Night,1994,40000000,19726050,59726050,5.4
Dazed and Confused,1993,6900000,7993039,14893039,7.4
Demolition Man,1993,57000000,159055768,216055768,6.4
For Love or Money,1993,30000000,11146270,41146270,5.7
The Firm,1993,42000000,270248367,312248367,6.6
Free Willy,1993,20000000,153698625,173698625,6
The Fugitive,1993,44000000,368875760,412875760,7.2
Geronimo: An American Legend,1993,35000000,18635620,53635620,5.9
Hard Target,1993,18000000,74189677,92189677,6.1
Hot Shots! Part Deux,1993,25000000,133752825,158752825,6.2
In the Line of Fire,1993,40000000,176997168,216997168,6.8
In the Name of the Father,1993,13000000,65796862,78796862,7.6
Jurassic Park,1993,63000000,920100000,983100000,7.6
Kalifornia,1993,9000000,2395231,11395231,6.5
Killing Zoe,1993,1500000,418961,1918961,6.1
Last Action Hero,1993,85000000,137298489,222298489,6.1
Manhattan Murder Mystery,1993,13500000,11285588,24785588,7.1
Menace II Society,1993,3500000,27900000,31400000,7.2
Executive Decision,1996,55000000,121969216,176969216,5.8
Mrs. Doubtfire,1993,25000000,441286195,466286195,7
The Next Karate Kid,1994,12000000,15826984,27826984,4.8
No Escape,1994,20000000,15340000,35340000,6.1
A Perfect World,1993,30000000,135130999,165130999,7.2
Philadelphia,1993,26000000,206678440,232678440,7.6
The Piano,1993,7000000,116700000,123700000,7.1
Poetic Justice,1993,14000000,27515786,41515786,6.9
The Ref,1994,11000000,11439193,22439193,6.7
The Remains of the Day,1993,11500000,23237911,34737911,7.5
Renaissance Man,1994,40000000,24332324,64332324,5.9
RoboCop 3,1993,22000000,10696210,32696210,4.2
Robin Hood: Men in Tights,1993,20000000,35739755,55739755,6.4
Romeo Is Bleeding,1993,11500000,3275585,14775585,5.7
Ruby in Paradise,1993,800000,1001437,1801437,5.6
Rudy,1993,12000000,22750363,34750363,7.2
Schindler's List,1993,22000000,321365567,343365567,8.3
Serial Mom,1994,13000000,7820688,20820688,6.4
The Shadow,1994,25000000,48063435,73063435,5.4
Sleepless in Seattle,1993,21000000,227799884,248799884,6.5
Sliver,1993,40000000,116300000,156300000,4.9
So I Married an Axe Murderer,1993,20000000,11585483,31585483,6.1
Super Mario Bros.,1993,48000000,20915465,68915465,4
Surviving the Game,1994,7400000,7690013,15090013,6.1
Terminal Velocity,1994,50000000,16478900,66478900,5
The Nightmare Before Christmas,1993,18000000,75634409,93634409,7.6
The Three Musketeers,1993,30000000,53898845,83898845,6.2
Tombstone,1993,25000000,56505065,81505065,7.4
True Romance,1993,12500000,12281551,24781551,7.5
The Pagemaster,1994,27000000,13670688,40670688,6.2
Home Alone,1990,18000000,476684675,494684675,7.1
Ghost,1990,22000000,505000000,527000000,6.9
Aladdin,1992,28000000,504050219,532050219,7.4
Terminator 2: Judgment Day,1991,100000000,520000000,620000000,7.7
Dances with Wolves,1990,22000000,424208848,446208848,7.6
The Silence of the Lambs,1991,19000000,272742922,291742922,8.1
Beauty and the Beast,1991,25000000,377350553,402350553,7.5
Pretty Woman,1990,14000000,463000000,477000000,7
Fargo,1996,7000000,60611975,67611975,7.7
Hellraiser: Bloodline,1996,4000000,16675000,20675000,4.9
Primal Fear,1996,30000000,102616183,132616183,7.4
Girl 6,1996,12000000,4939939,16939939,5.7
Courage Under Fire,1996,46000000,100860818,146860818,6.2
Mission: Impossible,1996,80000000,457696359,537696359,6.7
DragonHeart,1996,57000000,115267375,172267375,6.4
James and the Giant Peach,1996,38000000,28921264,66921264,6.2
Faithful,1996,13000000,9789900,22789900,4.8
Space Jam,1996,80000000,250200000,330200000,6.5
Mrs. Winterbourne,1996,25000000,10070000,35070000,5.5
The Quest,1996,30000000,57400547,87400547,5.3
Flipper,1996,25530000,20080020,45610020,5.3
The Horseman on the Roof,1995,35000000,15000000,50000000,6.7
The Craft,1996,15000000,24769466,39769466,6.3
Original Gangstas,1996,4800000,3014000,7814000,5.5
The Rock,1996,75000000,335062621,410062621,6.9
Twister,1996,92000000,494471524,586471524,6.1
The Arrival,1996,25000000,14048372,39048372,6.1
The Phantom,1996,45000000,17300889,62300889,4.7
Striptease,1996,50000000,113309743,163309743,4.4
Jack,1996,45000000,58620973,103620973,5.9
Trainspotting,1996,4000000,16491080,20491080,7.8
Independence Day,1996,75000000,816969268,891969268,6.7
The Fan,1996,55000000,18626419,73626419,5.7
The Hunchback of Notre Dame,1996,100000000,100138851,200138851,6.8
The Cable Guy,1996,47000000,102825796,149825796,5.7
Kingpin,1996,27000000,25023434,52023434,6.7
Eraser,1996,100000000,242295562,342295562,5.6
The Nutty Professor,1996,54000000,128769345,182769345,5.4
Daylight,1996,80000000,159212469,239212469,5.8
The Frighteners,1996,30000000,29359216,59359216,6.7
Lone Star,1996,5000000,13269963,18269963,6.9
Phenomenon,1996,32000000,152036382,184036382,6.2
She's the One,1996,3500000,9482579,12982579,5.7
A Time to Kill,1996,40000000,152266007,192266007,7
Fled,1996,25000000,17193231,42193231,5.2
Joe's Apartment,1996,13000000,4619014,17619014,5
The First Wives Club,1996,26000000,116400000,142400000,6.5
Ransom,1996,80000000,309492681,389492681,6.4
Chain Reaction,1996,50000000,60209334,110209334,5.3
Matilda,1996,36000000,33459416,69459416,6.9
Emma,1996,6000000,22231658,28231658,6.7
The Crow: City of Angels,1996,13000000,17917287,30917287,5.2
Bordello of Blood,1996,15000000,5600000,20600000,5
The Spitfire Grill,1996,6000000,12643776,18643776,6.8
Escape from L.A.,1996,50000000,42277365,92277365,5.6
Basquiat,1996,2962051,3011195,5973246,6.6
Tin Cup,1996,45000000,53854588,98854588,5.9
Dingo,1991,200000,300000,500000,6
Police Story 3: Supercop,1992,900000,20483423,21383423,6.7
Manny & Lo,1996,500000,431326,931326,6.3
Bound,1996,4500000,7011317,11511317,6.9
The Relic,1997,60000000,33956608,93956608,5.8
The Island of Dr. Moreau,1996,40000000,49627779,89627779,4.6
Bulletproof,1996,25000000,22611954,47611954,5.4
Halloween: The Curse of Michael Myers,1995,5000000,15116634,20116634,5
Maximum Risk,1996,25000000,51702483,76702483,5.3
Michael Collins,1996,28000000,16900000,44900000,6.8
Last Man Standing,1996,67000000,47267001,114267001,6.2
Set It Off,1996,9000000,41590886,50590886,6.9
Curdled,1996,2300000,49620,2349620,6.2
Extreme Measures,1996,38000000,17380126,55380126,5.7
The Chamber,1996,50000000,22540359,72540359,5.9
Cool Runnings,1993,14000000,154864401,168864401,6.8
Robin Hood: Prince of Thieves,1991,48000000,390493908,438493908,6.6
The Lawnmower Man,1992,10000000,32101000,42101000,5.4
Secrets & Lies,1996,4500000,13417292,17917292,7.1
Surviving Picasso,1996,16000000,1985001,17985001,5.3
The Long Kiss Goodnight,1996,65000000,89456761,154456761,6.4
The Ghost and the Darkness,1996,50000000,75000000,125000000,6.4
Get on the Bus,1996,2400000,5731103,8131103,7
Shadow Conspiracy,1997,45000000,2154540,47154540,4
Jude,1996,7000000,405000,7405000,6.6
Romeo + Juliet,1996,14500000,147298761,161798761,6.7
Swingers,1996,200000,4505922,4705922,6.8
Sleepers,1996,44000000,165615285,209615285,7.3
Reservoir Dogs,1992,1200000,14661007,15861007,8.1
Basic Instinct,1992,49000000,352927224,401927224,6.5
The Doors,1991,38000000,34416893,72416893,6.7
The Crying Game,1992,3705538,62548947,66254485,6.9
Glengarry Glen Ross,1992,12500000,10725228,23225228,7.5
Days of Thunder,1990,60000000,157920733,217920733,5.9
The Funeral,1996,12500000,1227324,13727324,7.3
The People vs. Larry Flynt,1996,36000000,20300385,56300385,6.8
Drop Dead Fred,1991,6788000,13878334,20666334,5.9
Bad Moon,1996,7000000,1100000,8100000,5.7
Delicatessen,1991,4000000,1794187,5794187,7.4
The English Patient,1996,27000000,231976425,258976425,7
Strictly Ballroom,1992,3000000,33946224,36946224,6.2
Madonna: Truth or Dare,1991,4,29,33,6.3
Paris is Burning,1990,500000,3779620,4279620,8.2
GoodFellas,1990,25000000,46836394,71836394,8.2
Braindead,1992,3000000,242623,3242623,7.4
Miller's Crossing,1990,14000000,5080409,19080409,7.5
Groundhog Day,1993,14600000,70906973,85506973,7.4
Unforgiven,1992,14000000,159157447,173157447,7.7
Fried Green Tomatoes,1991,11000000,119418501,130418501,7.6
Night on Earth,1991,3500000,2015810,5515810,7.5
Alien³,1992,50000000,159773545,209773545,6.2
Dracula,1992,40000000,215862692,255862692,7.1
Candyman,1992,6000000,25792310,31792310,6.2
Cape Fear,1991,35000000,182300000,217300000,7
Star Trek: First Contact,1996,46000000,150000000,196000000,7
Sling Blade,1996,1000000,24444121,25444121,7.4
Jingle All the Way,1996,60000000,129832389,189832389,5.5
The Preacher's Wife,1996,40000000,48093211,88093211,5.4
Ridicule,1996,3000000,2503829,5503829,7.4
101 Dalmatians,1996,54000000,320689294,374689294,5.6
Die Hard 2,1990,70000000,240031094,310031094,6.6
Star Trek VI: The Undiscovered Country,1991,27000000,96900000,123900000,6.7
Batman Returns,1992,80000000,280000000,360000000,6.6
Marked for Death,1990,12000000,46044400,58044400,5.6
Under Siege,1992,35000000,156563139,191563139,6.1
Mars Attacks!,1996,70000000,101371017,171371017,6.1
Citizen Ruth,1996,3000000,153155,3153155,6.8
Jerry Maguire,1996,50000000,273552592,323552592,6.7
Marvin's Room,1996,23000000,12803305,35803305,6.6
Scream,1996,14000000,173046663,187046663,7
The Last of the Mohicans,1992,40000000,75505856,115505856,7.1
Evita,1996,55000000,141047179,196047179,5.9
Turbulence,1997,55000000,11466088,66466088,5.2
Metro,1997,55000000,31987563,86987563,5.3
Dante's Peak,1997,116000000,178127760,294127760,5.8
Prefontaine,1997,8000000,589304,8589304,6.7
Absolute Power,1997,50000000,50068310,100068310,6.4
Vegas Vacation,1997,25000000,36400360,61400360,6
Lost Highway,1997,15000000,3675201,18675201,7.5
Rosewood,1997,30000000,13130349,43130349,6.7
Donnie Brasco,1997,35000000,41954997,76954997,7.4
Kama Sutra - A Tale of Love,1996,3000000,4109095,7109095,5.7
Private Parts,1997,28000000,41230799,69230799,6.7
The Saint,1997,68000000,118063304,186063304,5.9
Liar Liar,1997,45000000,302710615,347710615,6.4
Selena,1997,20000000,60000000,80000000,7.1
The Devil's Own,1997,90000000,140807547,230807547,5.9
Cats Don't Dance,1997,32000000,3566637,35566637,7.1
Turbo: A Power Rangers Movie,1997,10000000,17979739,27979739,4.6
Anna Karenina,1997,35000000,791830,35791830,6.4
Anaconda,1997,45000000,136885767,181885767,4.8
Austin Powers: International Man of Mystery,1997,16500000,67683989,84183989,6.5
Breakdown,1997,36000000,50159144,86159144,6.6
The Fifth Element,1997,90000000,263920180,353920180,7.3
Love! Valour! Compassion!,1997,2000000,2900000,4900000,5.7
The Lost World: Jurassic Park,1997,73000000,229074524,302074524,6.2
Con Air,1997,75000000,224012234,299012234,6.5
Speed 2: Cruise Control,1997,160000000,164508066,324508066,4.1
Squeeze,1997,500000,10300,510300,6
Batman & Robin,1997,125000000,238207122,363207122,4.2
Hercules,1997,85000000,252712101,337712101,7.3
My Best Friend's Wedding,1997,38000000,299288605,337288605,6.4
Face/Off,1997,80000000,245676146,325676146,6.8
Men in Black,1997,90000000,589390539,679390539,6.9
A Simple Wish,1997,28000000,8345056,36345056,5.5
Contact,1997,90000000,171120329,261120329,7.2
G.I. Jane,1997,50000000,48169156,98169156,6
Cop Land,1997,15000000,44862187,59862187,6.6
Event Horizon,1997,60000000,26673242,86673242,6.4
Spawn,1997,40000000,87840042,127840042,5
Air Bud,1997,3000000,23144499,26144499,5.3
Picture Perfect,1997,19000000,44332015,63332015,5.1
Conspiracy Theory,1997,75000000,136982834,211982834,6.5
Steel,1997,16000000,1686429,17686429,4.2
Mimic,1997,30000000,25480490,55480490,5.7
Air Force One,1997,85000000,315156409,400156409,6.2
One Eight Seven,1997,20000000,5716080,25716080,6.5
The Hunt for Red October,1990,30000000,199200000,229200000,7.2
L.A. Confidential,1997,35000000,126216940,161216940,7.7
Seven Years in Tibet,1997,70000000,131457682,201457682,7
Kiss the Girls,1997,27000000,60527873,87527873,6.2
Wishmaster,1997,5000000,15719109,20719109,5.6
The Game,1997,50000000,109423648,159423648,7.5
Fire Down Below,1997,60000000,16000000,76000000,5
U Turn,1997,19000000,6682098,25682098,6.5
The Ice Storm,1997,18000000,8038061,26038061,6.9
Chasing Amy,1997,250000,12021272,12271272,6.7
The Full Monty,1997,3500000,257850122,261350122,6.9
I Know What You Did Last Summer,1997,17000000,125586134,142586134,5.6
The Devil's Advocate,1997,57000000,152944660,209944660,7.2
Playing God,1997,12000000,4000000,16000000,5.6
The House of Yes,1997,1500000,626057,2126057,6.3
Gattaca,1997,36000000,12532777,48532777,7.5
Switchback,1997,37000000,6482195,43482195,5.8
Bean,1997,18000000,251212670,269212670,6.3
Mad City,1997,50000000,10541523,60541523,5.9
One Night Stand,1997,24000000,2642983,26642983,5.7
The Rainmaker,1997,40000000,45916769,85916769,6.7
Boogie Nights,1997,15000000,43101594,58101594,7.5
Starship Troopers,1997,105000000,121214377,226214377,6.7
The Joy Luck Club,1993,11000000,32861136,43861136,7.1
Sliding Doors,1998,6000000,58000000,64000000,6.6
Mortal Kombat: Annihilation,1997,30000000,51376861,81376861,3.8
The Truman Show,1998,60000000,264118201,324118201,7.8
The Jackal,1997,60000000,159330280,219330280,6.1
Anastasia,1997,53000000,139804348,192804348,7.4
The Man Who Knew Too Little,1997,20000000,13801755,33801755,6.5
Alien: Resurrection,1997,70000000,162000000,232000000,5.9
Amistad,1997,36000000,74000000,110000000,6.8
Deconstructing Harry,1997,20000000,10686841,30686841,7.3
Flubber,1997,80000000,177977226,257977226,5.3
For Richer or Poorer,1997,35000000,31611225,66611225,5.6
Good Will Hunting,1997,10000000,225933435,235933435,7.9
Home Alone 3,1997,32000000,79082515,111082515,5.1
Midnight in the Garden of Good and Evil,1997,35000000,25105255,60105255,6.3
MouseHunt,1997,38000000,122417389,160417389,6.2
Scream 2,1997,24000000,172363301,196363301,6.1
The Sweet Hereafter,1997,5000000,3263585,8263585,6.8
Titanic,1997,200000000,1845034188,2045034188,7.5
Tomorrow Never Dies,1997,110000000,333011068,443011068,6
The Postman,1997,80000000,17626234,97626234,6.1
The Horse Whisperer,1998,60000000,186883563,246883563,6.7
Jackie Brown,1997,12000000,39673162,51673162,7.3
Kundun,1997,28000000,5684789,33684789,6.8
The Big Lebowski,1998,15000000,46189568,61189568,7.8
Great Expectations,1998,25000000,55494066,80494066,6.4
Wag the Dog,1997,15000000,64256513,79256513,6.7
Dark City,1998,27000000,27200316,54200316,7.2
Hard Rain,1998,70000000,19870567,89870567,5.5
Half Baked,1998,8000000,17460020,25460020,6.4
Shooting Fish,1997,3000000,302204,3302204,7
Spice World,1997,25000000,100000000,125000000,4.7
Deep Rising,1998,45000000,11203026,56203026,6
The Replacement Killers,1998,30000000,19204929,49204929,6
The Night Flier,1997,1000000,91549,1091549,5.7
Blues Brothers 2000,1998,28000000,14051384,42051384,5.2
The Wedding Singer,1998,18000000,123306987,141306987,6.5
Sphere,1998,75000000,13100000,88100000,5.8
As Good as It Gets,1997,50000000,314178011,364178011,7.2
King of New York,1990,1000000,2554476,3554476,6.5
U.S. Marshals,1998,60000000,102367405,162367405,6.2
The Newton Boys,1998,27000000,76000000,103000000,5.9
Wild Things,1998,20000000,67200000,87200000,6.3
Two Girls and a Guy,1997,1000000,2057193,3057193,5.4
The Object of My Affection,1998,15000000,46905889,61905889,5.6
Meet the Deedles,1998,24000000,4562146,28562146,4.1
Lost in Space,1998,80000000,136159423,216159423,5
The Spanish Prisoner,1997,10000000,13835130,23835130,7.1
City of Angels,1998,55000000,198685114,253685114,6.5
He Got Game,1998,25000000,21567853,46567853,6.7
Zero Effect,1998,5000000,1980338,6980338,6
"An Alan Smithee Film: Burn, Hollywood, Burn",1998,10000000,45779,10045779,3
Mr. Nice Guy,1997,12716953,18814720,31531673,6.2
Species II,1998,35000000,19165560,54165560,4.5
The Big Hit,1998,13000000,27007143,40007143,6.1
Deep Impact,1998,75000000,140464664,215464664,5.9
Woo,1998,13000000,8026971,21026971,5.5
Quest for Camelot,1998,40000000,38172500,78172500,6.9
Godzilla,1998,130000000,379014294,509014294,5.3
Bulworth,1998,30000000,29202884,59202884,6.3
Fear and Loathing in Las Vegas,1998,18500000,10680275,29180275,7.2
The Opposite of Sex,1998,5000000,5879254,10879254,5.9
A Perfect Murder,1998,60000000,128038368,188038368,6.3
Six Days Seven Nights,1998,70000000,164000000,234000000,5.6
Can't Hardly Wait,1998,10000000,25605015,35605015,6.1
Children of Heaven,1997,180000,900000,1080000,7.8
Mulan,1998,90000000,304320254,394320254,7.6
The X Files,1998,66000000,189198313,255198313,6.6
Doctor Dolittle,1998,71000000,294456605,365456605,5.4
Out of Sight,1998,48000000,77745568,125745568,6.5
Buffalo '66,1998,1500000,2375097,3875097,7.2
Armageddon,1998,140000000,553799566,693799566,6.5
Lethal Weapon 4,1998,140000000,285444603,425444603,6.3
Small Soldiers,1998,40000000,54682547,94682547,6.2
Pi,1998,60000,3221152,3281152,7.1
There's Something About Mary,1998,23000000,369884651,392884651,6.5
Freddy's Dead: The Final Nightmare,1991,11000000,34872033,45872033,5.1
Child's Play 2,1990,13000000,35763605,48763605,5.8
Child's Play 3,1991,13000000,20560255,33560255,5.5
Lethal Weapon 3,1992,35000000,321731527,356731527,6.4
Gremlins 2: The New Batch,1990,50000000,41482207,91482207,6.3
The Mask of Zorro,1998,95000000,250288523,345288523,6.3
Back to the Future Part III,1990,40000000,244527583,284527583,7.1
The Godfather: Part III,1990,54000000,136766062,190766062,7.1
The Rapture,1991,1227401,1277401,2504802,6.4
Lolita,1997,62000000,1060056,63060056,7
Disturbing Behavior,1998,15000000,17507368,32507368,5.5
Jane Austen's Mafia!,1998,10000000,19000000,29000000,5.4
Saving Private Ryan,1998,70000000,481840909,551840909,7.9
Hocus Pocus,1993,28000000,39514713,67514713,6.5
Honey I Blew Up the Kid,1992,40000000,58662452,98662452,4.8
The Negotiator,1998,50000000,44547681,94547681,6.8
The Mighty Ducks,1992,10000000,50752337,60752337,6.4
The Rescuers Down Under,1990,37931000,47431461,85362461,6.6
The Rocketeer,1991,42000000,62000000,104000000,6.3
Halloween: H20,1998,17000000,55041738,72041738,5.7
Graveyard Shift,1990,10500000,11582891,22082891,4.5
The Addams Family,1991,30000000,191502426,221502426,6.7
Ever After: A Cinderella Story,1998,26000000,65705772,91705772,6.8
Snake Eyes,1998,73000000,103891409,176891409,5.8
"First Love, Last Rites",1998,300000,40542,340542,3
The Avengers,1998,60000000,48585416,108585416,4.4
How Stella Got Her Groove Back,1998,20000000,37672350,57672350,6
The Neverending Story II: The Next Chapter,1990,32000000,16283667,48283667,5.5
Your Friends & Neighbors,1998,5000000,4710749,9710749,5.9
Blade,1998,45000000,131183530,176183530,6.5
54,1998,13000000,16757163,29757163,5.5
I Married a Strange Person!,1998,250,203,453,7.5
Rounders,1998,12000000,22921898,34921898,6.9
Cube,1997,250000,501818,751818,6.9
Simon Birch,1998,20000000,18253415,38253415,6.5
Without Limits,1998,25000000,777423,25777423,6.4
Nothing but Trouble,1991,40000000,8479793,48479793,5
A Few Good Men,1992,40000000,243240178,283240178,7.1
Indecent Proposal,1993,38000000,266614059,304614059,5.8
Rush Hour,1998,33000000,244386864,277386864,6.8
Six-String Samurai,1998,2000000,124494,2124494,5.8
Ronin,1998,55000000,41610884,96610884,6.8
Urban Legend,1998,14000000,72527595,86527595,5.6
The Sheltering Sky,1990,25000000,2075084,27075084,6.4
The Player,1992,8000000,21706101,29706101,6.9
Edward Scissorhands,1990,20000000,53000000,73000000,7.5
Antz,1998,60000000,171757863,231757863,6
A Night at the Roxbury,1998,17000000,30331165,47331165,5.9
What Dreams May Come,1998,85000000,71485043,156485043,6.8
Strangeland,1998,1100000,631221,1731221,4.7
My Cousin Vinny,1992,11000000,64088552,75088552,7.3
Bride of Chucky,1998,25000000,50671850,75671850,5.5
Practical Magic,1998,75000000,46683377,121683377,6.3
Happiness,1998,3000000,2807390,5807390,7.4
Soldier,1998,75000000,14567883,89567883,6.1
Life Is Beautiful,1997,20000000,229400000,249400000,8.3
Tales from the Darkside: The Movie,1990,3500000,16324573,19824573,5.8
American History X,1998,20000000,23875127,43875127,8.2
Living Out Loud,1998,12000000,12902790,24902790,5.4
Gods and Monsters,1998,10000000,6451628,16451628,6.8
The Siege,1998,70000000,116672912,186672912,6.1
The Waterboy,1998,23000000,185991646,208991646,5.9
Elizabeth,1998,30000000,82150642,112150642,7.2
I Still Know What You Did Last Summer,1998,65000000,40002112,105002112,5.1
Meet Joe Black,1998,90000000,142940100,232940100,6.9
Enemy of the State,1998,90000000,250649836,340649836,6.7
The Rugrats Movie,1998,30000000,100491683,130491683,5.8
A Bug's Life,1998,120000000,363258859,483258859,6.8
Central Station,1998,2900000,5596708,8496708,7.6
Babe: Pig in the City,1998,90000000,69131860,159131860,5.3
Home Fries,1998,15000000,10443316,25443316,4.8
Ringmaster,1998,3500000,9247881,12747881,3.8
Very Bad Things,1998,30000000,9898412,39898412,6.2
Psycho,1998,60000000,37141130,97141130,4.8
Star Trek: Insurrection,1998,70000000,118000000,188000000,6.3
The Prince of Egypt,1998,70000000,218613188,288613188,6.9
Rushmore,1998,9000000,17096053,26096053,7.5
Shakespeare in Love,1998,25000000,289317794,314317794,6.8
Rocky V,1990,42000000,119946358,161946358,5.3
You've Got Mail,1998,65000000,250821495,315821495,6.3
The Thin Red Line,1998,52000000,98126565,150126565,7.2
The Faculty,1998,15000000,40283321,55283321,6.2
Patch Adams,1998,50000000,202292902,252292902,7
A Civil Action,1998,70000000,56702901,126702901,6.1
Tea with Mussolini,1999,12000000,21001563,33001563,5.8
Affliction,1997,6000000,6330054,12330054,5.8
Playing by Heart,1998,20000000,3970078,23970078,6.6
Virus,1999,75000000,14010690,89010690,5
Texas Chainsaw Massacre: The Next Generation,1994,600000,185898,785898,3.9
She's All That,1999,10000000,103166989,113166989,5.7
"Blood, Guts, Bullets and Octane",1998,7300,13674,20974,6
Payback,1999,90000000,161626121,251626121,6.7
Simply Irresistible,1999,6000000,4398989,10398989,5.5
Blast from the Past,1999,35000000,40263020,75263020,6.3
Message in a Bottle,1999,80000000,118880016,198880016,5.9
My Favorite Martian,1999,65000000,36850101,101850101,5.1
Jawbreaker,1999,3000000,3076820,6076820,5.9
Office Space,1999,10000000,12827813,22827813,7.4
200 Cigarettes,1999,6000000,6852450,12852450,6.1
8MM,1999,40000000,96618699,136618699,6.1
Pet Sematary II,1992,8000000,17092453,25092453,5
Children of the Corn II: The Final Sacrifice,1993,900000,6980986,7880986,4.5
Analyze This,1999,80000000,176885658,256885658,6.4
The Corruptor,1999,25000000,15156200,40156200,6.1
Cruel Intentions,1999,10500000,75902208,86402208,6.6
"Lock, Stock and Two Smoking Barrels",1998,1350000,3897569,5247569,7.5
The Deep End of the Ocean,1999,38000000,28121100,66121100,6
The Rage: Carrie 2,1999,21000000,17762705,38762705,5.1
Baby Geniuses,1999,12000000,36450736,48450736,3.3
Forces of Nature,1999,75000000,93888180,168888180,5.1
The King and I,1999,25000000,12000000,37000000,5
The Mod Squad,1999,50000000,13260050,63260050,4.1
The Matrix,1999,63000000,463517383,526517383,7.9
10 Things I Hate About You,1999,16000000,53478166,69478166,7.3
The Out-of-Towners,1999,75000000,29000000,104000000,5.1
Following,1998,6000,48482,54482,7.2
Go,1999,6500000,28451622,34951622,7
Never Been Kissed,1999,25000000,84565230,109565230,5.8
Twin Dragons,1992,10000000,8359717,18359717,6.2
Cookie's Fortune,1999,10000000,10920544,20920544,6.2
Life,1999,80000000,73345029,153345029,6.4
Open Your Eyes,1997,2900000,368234,3268234,7.4
Lost & Found,1999,1,100,101,4.9
eXistenZ,1999,15000000,2856712,17856712,6.7
Entrapment,1999,66000000,212404396,278404396,6
Idle Hands,1999,25000000,4152230,29152230,6.1
Dick Tracy,1990,47000000,103738726,150738726,5.9
The Mummy,1999,80000000,415885488,495885488,6.6
The Castle,1997,786675,861789,1648464,7.4
Edge of Seventeen,1998,1500000,870751,2370751,5.7
Star Wars: Episode I - The Phantom Menace,1999,115000000,924317558,1039317558,6.4
Notting Hill,1999,42000000,363889678,405889678,7
The Thirteenth Floor,1999,16000000,18564088,34564088,6.8
Limbo,1999,8000000,1997807,9997807,7
Austin Powers: The Spy Who Shagged Me,1999,33000000,310940086,343940086,6.1
The Red Violin,1998,18000000,9495408,27495408,7.2
Tarzan,1999,150000000,448000000,598000000,7.1
The General's Daughter,1999,60000000,149705852,209705852,6.1
An Ideal Husband,1999,14000000,18535191,32535191,6.3
Run Lola Run,1998,1530000,7267585,8797585,7.2
Big Daddy,1999,34200000,234801895,269001895,6.2
The Dinner Game,1998,12500000,78599508,91099508,7.7
Arachnophobia,1990,31000000,53208180,84208180,6.2
Wild Wild West,1999,170000000,222104681,392104681,5.1
American Pie,1999,11000000,235483004,246483004,6.4
Muppets from Space,1999,24000000,16290976,40290976,5.8
The Blair Witch Project,1999,60000,248000000,248060000,6.3
Eyes Wide Shut,1999,65000000,162091208,227091208,7.1
Lake Placid,1999,27000000,56870414,83870414,5.5
The Wood,1999,6000000,25059640,31059640,7.1
Drop Dead Gorgeous,1999,10000000,10571408,20571408,6.5
The Haunting,1999,80000000,91188905,171188905,5.2
Trick,1999,450000,2049595,2499595,6.7
Deep Blue Sea,1999,60000000,73648228,133648228,5.6
Mystery Men,1999,68000000,29762011,97762011,5.7
Runaway Bride,1999,70000000,309457509,379457509,5.8
Dick,1999,13000000,27500000,40500000,5.7
The Iron Giant,1999,70000000,23159305,93159305,7.6
The Sixth Sense,1999,40000000,672806292,712806292,7.7
The Thomas Crown Affair,1999,48000000,124305181,172305181,6.7
Brokedown Palace,1999,25000000,13000000,38000000,6.2
Detroit Rock City,1999,6500000,4217115,10717115,6.7
Never Talk to Strangers,1995,6400000,6,6400006,4.7
An American Werewolf in Paris,1997,22000000,26570463,48570463,5.3
The Pelican Brief,1993,45000000,195268056,240268056,6.3
Teaching Mrs. Tingle,1999,13000000,8946237,21946237,5.3
Universal Soldier: The Return,1999,45000000,10667893,55667893,4.2
In Too Deep,1999,7000000,14011454,21011454,6.3
The 13th Warrior,1999,160000000,61698899,221698899,6.4
The Astronaut's Wife,1999,75000000,19598588,94598588,5.5
Chill Factor,1999,70000000,11263966,81263966,5.3
Outside Providence,1999,7000000,7292175,14292175,5.6
Stigmata,1999,29000000,50041732,79041732,6
Stir of Echoes,1999,12000000,21133087,33133087,6.5
American Beauty,1999,15000000,356296601,371296601,7.9
Blue Streak,1999,65000000,117758500,182758500,6.1
Thumbelina,1994,28000000,11373501,39373501,6.1
Double Jeopardy,1999,70000000,177841558,247841558,6.2
Guinevere,1999,2600000,614202,3214202,5.9
Drive Me Crazy,1999,8000000,22593409,30593409,5.8
"Mystery, Alaska",1999,28000000,8888143,36888143,6
Three Kings,1999,75000000,108000000,183000000,6.6
"Happy, Texas",1999,1700000,1943649,3643649,5.5
The Dark Half,1993,15000000,10611160,25611160,5.4
Random Hearts,1999,64000000,74608570,138608570,5.3
Boys Don't Cry,1999,2000000,11540607,13540607,7.2
The Limey,1999,10000000,3193102,13193102,6.6
Total Recall,1990,65000000,261317921,326317921,7.1
Hard Eight,1996,3000000,222559,3222559,6.8
Home Alone 2: Lost in New York,1992,18000000,358991681,376991681,6.3
Naturally Native,1999,700000,10508,710508,0
Fight Club,1999,63000000,100853753,163853753,8.3
The Story of Us,1999,50000000,58900031,108900031,5.9
The Best Man,1999,9000000,34573780,43573780,6.8
RoboCop 2,1990,35000000,45681173,80681173,5.6
House on Haunted Hill,1999,19000000,40846082,59846082,5.5
Music of the Heart,1999,27000000,14859394,41859394,6.3
Being John Malkovich,1999,13000000,22863596,35863596,7.3
Dreaming of Joseph Lees,1999,2000000,7,2000007,6
Princess Mononoke,1997,26500000,159375308,185875308,8.2
The Bachelor,1999,51000000,36911617,87911617,4.5
The Bone Collector,1999,73000000,151493655,224493655,6.5
The Insider,1999,90000000,60289912,150289912,7.3
Falling Down,1993,25000000,40903593,65903593,7.2
Anywhere But Here,1999,23000000,18653615,41653615,5.9
Dogma,1999,10000000,30652890,40652890,6.8
The Messenger: The Story of Joan of Arc,1999,60000000,66976317,126976317,6.2
Pokémon: The First Movie: Mewtwo Strikes Back,1998,30000000,163644662,193644662,6.7
Sleepy Hollow,1999,100000000,206071502,306071502,6.9
The World Is Not Enough,1999,135000000,361832400,496832400,6
All About My Mother,1999,8272296,67872296,76144592,7.4
Stanley & Iris,1990,23000000,5820015,28820015,5.7
Backdraft,1991,75000000,152368585,227368585,6.4
The Fisher King,1991,24000000,41895491,65895491,7.2
End of Days,1999,100000000,211989043,311989043,5.5
Toy Story 2,1999,90000000,497366869,587366869,7.3
Ride with the Devil,1999,38000000,635096,38635096,6.6
Tumbleweeds,1999,312000,1281176,1593176,6.2
The End of the Affair,1999,23000000,10827816,33827816,6.6
The Bonfire of the Vanities,1990,47000000,15691192,62691192,5.3
The Two Jakes,1990,19000000,10000000,29000000,6.2
Deuce Bigalow: Male Gigolo,1999,17000000,65535067,82535067,5.4
The Green Mile,1999,60000000,284600000,344600000,8.2
The Cider House Rules,1999,24000000,88545092,112545092,6.9
Bicentennial Man,1999,100000000,93700000,193700000,6.9
Stuart Little,1999,133000000,300135367,433135367,5.8
Fantasia 2000,1999,80000000,90874570,170874570,7
Magnolia,1999,37000000,48451803,85451803,7.5
Onegin,1999,14000000,206128,14206128,5.8
Simpatico,1999,10000000,929606,10929606,5.3
Any Given Sunday,1999,55000000,100230832,155230832,6.8
Man on the Moon,1999,82000000,47434430,129434430,6.9
Galaxy Quest,1999,45000000,90683916,135683916,6.9
The Talented Mr. Ripley,1999,40000000,128798265,168798265,7.1
The Hurricane,1999,50000000,73956241,123956241,7.2
Angela's Ashes,1999,25,13,38,7
Play It to the Bone,1999,24000000,8434146,32434146,5.7
The Terrorist,1998,24554,140021,164575,8.1
Batman: Mask of the Phantasm,1993,6000000,5617391,11617391,7.4
Poison,1991,250000,609524,859524,6.4
Malcolm X,1992,34000000,48169908,82169908,7.3
Sister Act,1992,31000000,231605150,262605150,6.5
Sister Act 2: Back in the Habit,1993,38000000,57319029,95319029,5.9
The Hand that Rocks the Cradle,1992,11700000,88036683,99736683,6.5
Alive,1993,32000000,36733909,68733909,6.7
Scent of a Woman,1992,31000000,134095253,165095253,7.3
Wayne's World,1992,20000000,121697323,141697323,6.5
A League of Their Own,1992,40000000,107458785,147458785,6.8
Patriot Games,1992,45000000,178051587,223051587,6.4
The Bodyguard,1992,25000000,411006740,436006740,6.2
Death Becomes Her,1992,55000000,149022650,204022650,6.3
Far and Away,1992,60000000,137783840,197783840,6.3
Twin Peaks: Fire Walk with Me,1992,10000000,4160851,14160851,7.3
Buffy the Vampire Slayer,1992,7000000,16624456,23624456,5.3
El Mariachi,1992,220000,2040920,2260920,6.6
Bad Lieutenant,1992,1000000,2019469,3019469,6.9
Single White Female,1992,16000000,48017402,64017402,6
The Boondock Saints,1999,6000000,30471,6030471,7.2
Beyond the Mat,1999,2053648,500000,2553648,7.8
The Ninth Gate,1999,38000000,58401898,96401898,6.3
JFK,1991,40000000,205405498,245405498,7.5
Thelma & Louise,1991,16000000,45361000,61361000,7.2
Mo' Better Blues,1990,10000000,16153593,26153593,6.3
Jungle Fever,1991,14000000,32482682,46482682,6
Death Wish 5: The Face of Death,1994,5000000,1702394,6702394,5
Cool as Ice,1991,6000000,1193062,7193062,4.7
Teenage Mutant Ninja Turtles,1990,13500000,202000000,215500000,6.5
Teenage Mutant Ninja Turtles II: The Secret of the Ooze,1991,25000000,78000000,103000000,5.8
Teenage Mutant Ninja Turtles III,1993,21000000,42000000,63000000,5.1
Jacob's Ladder,1990,25000000,25965144,50965144,7.3
Hook,1991,70000000,300854823,370854823,6.7
Misery,1990,20000000,61276872,81276872,7.6
Mr. Saturday Night,1992,43000000,13300000,56300000,5.2
Black and White,1999,10000000,5241315,15241315,4.6
The Prince of Tides,1991,30000000,74787599,104787599,5.9
East Is East,1999,3800000,28200000,32000000,6.5
The Virgin Suicides,1999,6000000,10409377,16409377,7.1
Jennifer Eight,1992,20000000,11390479,31390479,5.8
The Idiots,1998,2500000,7235,2507235,6.7
Carnosaur,1993,1000000,1753979,2753979,3.9
Human Traffic,1999,600000,4000000,4600000,6.8
The Myth Of Fingerprints,1997,2000000,458815,2458815,3.4
Stay Tuned,1992,25000000,10736401,35736401,6
Flatliners,1990,26000000,61489265,87489265,6.3
Predator 2,1990,35000000,57120318,92120318,6
Butterfly,1999,3000000,6000000,9000000,7.2
House Party,1990,2500000,26386000,28886000,6.1
But I'm a Cheerleader,1999,1200000,2600000,3800000,6.5
Pokémon: The Movie 2000,1999,30000000,133949270,163949270,6.4
What About Bob?,1991,35000000,63710000,98710000,6.7
The Crush,1993,6000000,13609396,19609396,5.5
Silent Fall,1994,30000000,3180674,33180674,5.2
Godzilla 2000,1999,1000000,10037390,11037390,5.9
The Naked Gun 2½: The Smell of Fear,1991,23000000,86930411,109930411,6.6
Hellraiser III: Hell on Earth,1992,5000000,12534961,17534961,5.3
Don't Tell Mom the Babysitter's Dead,1991,10000000,25196249,35196249,5.8
Death Warrant,1990,4000000,16853487,20853487,5.4
Double Impact,1991,15000000,30102717,45102717,5.3
Harley Davidson and the Marlboro Man,1991,23000000,7434726,30434726,6.1
Mermaids,1990,31000000,35419397,66419397,6.5
A Home of Our Own,1993,12000000,1703282,13703282,7
For the Boys,1991,40000000,23202444,63202444,6.5
Postcards from the Edge,1990,22000000,39071603,61071603,6.3
City Slickers,1991,27000000,179033791,206033791,6.2
Point Break,1991,24000000,83531958,107531958,6.9
Unlawful Entry,1992,23000000,57138719,80138719,5.8
Shadows and Fog,1991,14000000,2735731,16735731,7
Cure,1997,20000,99000,119000,7.4
Silent Trigger,1996,15000000,76382,15076382,5
Another 48 Hrs.,1990,38000000,153518974,191518974,5.8
Dragon: The Bruce Lee Story,1993,14000000,63513743,77513743,6.8
Baby's Day Out,1994,50000000,16671505,66671505,5.8
The Good Son,1993,17000000,44456478,61456478,6.2
Intersection,1994,45000000,21355893,66355893,5.1
A Troll in Central Park,1994,23000000,71368,23071368,4.4
Split Second,1992,7,5,12,5.8
Delirious,1991,18000000,5546827,23546827,5.5
Rambling Rose,1991,7500000,6266621,13766621,6.4
White Fang,1991,14000000,34793160,48793160,6.5
Rapid Fire,1992,10000000,14356479,24356479,6.2
Hot Shots!,1991,26000000,181096164,207096164,6.4
Camilla,1994,8500000,250993,8750993,4.9
Captain Ron,1992,24000000,22518097,46518097,5.6
Spaced Invaders,1990,3000000,15369573,18369573,4.8
Claire of the Moon,1992,130000,799674,929674,5.2
Jason Goes to Hell: The Final Friday,1993,3000000,15938065,18938065,4.2
Return to the Blue Lagoon,1991,11000000,2807854,13807854,5.2
Body of Evidence,1993,30000000,13273595,43273595,4.5
Running Time,1997,130000,1596,131596,6.2
Dennis the Menace,1993,35000000,117270765,152270765,5.5
Ringu,1998,1200000,8690429,9890429,6.9
Ringu 2,1999,6000000,18686644,24686644,5.4
Wind,1992,29000000,5519569,34519569,6.1
The Marrying Man,1991,26000000,12454768,38454768,5
Scenes from a Mall,1991,3000000,9563393,12563393,4.8
Oscar,1991,35000000,23562716,58562716,6.2
Barton Fink,1991,9000000,6153939,15153939,7.4
Shattered,1991,22000000,11511031,33511031,6.1
"Bodies, Rest & Motion",1993,2500000,764083,3264083,4.3
Loose Cannons,1990,1500000,5585154,7085154,4.9
Man's Best Friend,1993,6000000,12974636,18974636,5.5
Showdown in Little Tokyo,1991,8000000,2275557,10275557,5.7
Tremors,1990,11000000,48572000,59572000,6.6
Memoirs of an Invisible Man,1992,40000000,14358033,54358033,5.7
Beethoven's 2nd,1993,15000000,118243066,133243066,5
Boyz n the Hood,1991,6500000,57504069,64004069,7.4
Bugsy,1991,30000000,49114016,79114016,6
Consenting Adults,1992,18000000,21591728,39591728,5.6
Sleeping with the Enemy,1991,19000000,174999005,193999005,6.1
PCU,1994,9000000,4350774,13350774,6
The Rookie,1990,10000000,21633874,31633874,5.6
A Rage in Harlem,1991,8000000,10400000,18400000,5.8
The Gun in Betty Lou's Handbag,1992,13000000,3721911,16721911,4.1
Article 99,1992,18000000,6375979,24375979,5.5
There Goes My Baby,1994,10500000,123509,10623509,8.5
Mobsters,1991,23000000,20246790,43246790,5.7
Darkman,1990,16000000,48878502,64878502,6.2
New Jack City,1991,8500000,47624253,56124253,6.3
Highlander II: The Quickening,1991,30000000,15556340,45556340,4.5
Hudson Hawk,1991,65000000,17218080,82218080,5.4
Kindergarten Cop,1990,15000000,201957688,216957688,5.8
The Last Boy Scout,1991,29000000,59509925,88509925,6.5
Mr. Destiny,1990,20000000,15379253,35379253,6.1
Passenger 57,1992,15000000,44065653,59065653,5.6
Presumed Innocent,1990,22000000,221303188,243303188,6.6
Pure Luck,1991,17010000,24941969,41951969,5.5
The Wedding Banquet,1993,1000000,6933459,7933459,6.8
Radio Flyer,1992,35000000,4651977,39651977,6.6
Wild at Heart,1990,9500000,14560247,24060247,7
Leprechaun,1993,900000,8556940,9456940,5.1
Run,1991,16000000,4409328,20409328,5.5
"Car 54, Where Are You?",1994,10700000,1238080,11938080,3
Only the Strong,1993,6000000,3283371,9283371,6.8
The Adventures of Ford Fairlane,1990,49000000,20423389,69423389,6.2
Cool World,1992,30000000,14110589,44110589,4.9
Money for Nothing,1993,11000000,1044824,12044824,5.1
Clifford,1994,19000000,7411659,26411659,5.3
The Wind in the Willows,1996,12,1,13,4.9
Raising Cain,1992,12000000,37170057,49170057,5.9
Noises Off...,1992,12000000,2280148,14280148,7
On Deadly Ground,1994,50000000,49000000,99000000,4.6
Forever Fever,1998,1070000,570000,1640000,5.1
The Indian Runner,1991,7000000,191125,7191125,6.2
Nightbreed,1990,11000000,8862354,19862354,6.4
Space Truckers,1996,25000000,1614266,26614266,5.6
Paradise,1991,34000000,18634643,52634643,5.6
At Play in the Fields of the Lord,1991,36000000,1345903,37345903,5.8
Night of the Living Dead,1990,4200000,5835247,10035247,6.7
City of Joy,1992,27000000,14683921,41683921,6.3
The Doctor,1991,12000000,38120905,50120905,6.6
Meet the Applegates,1991,5000000,485772,5485772,5
Rapa Nui,1994,20000000,305070,20305070,6.2
Juice,1992,5000000,20146880,25146880,7
Search and Destroy,1995,4000000,389503,4389503,6.1
The Super,1991,22000000,11000863,33000863,5.5
1492: Conquest of Paradise,1992,47000000,7191399,54191399,6.1
Fire in the Sky,1993,19885552,19724334,39609886,6.5
Cry-Baby,1990,11000000,8266343,19266343,6.4
Frankenhooker,1990,2500000,205068,2705068,5.7
Hard to Kill,1990,10000000,47410000,57410000,5.6
Havana,1990,40000000,9243140,49243140,5.5
Lionheart,1990,6000000,24078196,30078196,5.9
Closet Land,1991,4000000,259012,4259012,6.6
Dutch,1991,17000000,4603929,21603929,6.4
Mannequin Two: On the Move,1991,13000000,3752426,16752426,4.6
Out for Justice,1991,14000000,39673161,53673161,5.9
Diggstown,1992,17000000,4836637,21836637,6.5
Fortress,1992,8000000,6739141,14739141,5.7
Josh and S.A.M.,1993,18000000,1528163,19528163,5
Philadelphia Experiment II,1993,5000000,2970,5002970,5
Beowulf,1999,20000000,1531251,21531251,4.4
A Place Called Chiapas,1998,891000,229000,1120000,6.9
Dil Se..,1998,5200000,13000000,18200000,6.7
Kuch Kuch Hota Hai,1998,1530000,15306000,16836000,7.5
Man Trouble,1992,30,4,34,4.7
Beastmaster 2: Through the Portal of Time,1991,6000000,869325,6869325,4.6
The Chase,1994,26000000,8009329,34009329,5.6
Double Dragon,1994,3500000,2341309,5841309,3.9
Bopha!,1993,12000000,212483,12212483,0
Once Upon a Forest,1993,13000000,6582052,19582052,6.2
Airborne,1993,2600000,2850263,5450263,6.1
Most Wanted,1997,25000000,11838218,36838218,5.8
Hardware,1990,1500000,5728953,7228953,5.6
Dilwale Dulhania Le Jayenge,1995,13200000,100000000,113200000,9.1
Leprechaun 2,1994,2000000,2260622,4260622,4.8
Son of the Pink Panther,1993,25000000,2438031,27438031,3.8
Swoon,1992,250000,340147,590147,5.9
Dark Angel,1990,7000000,9229401,16229401,5.5
Return of the Living Dead 3,1993,2000000,54207,2054207,5.9
Doctor Who,1996,5000000,42000000,47000000,6
Rock-A-Doodle,1991,18000000,11657385,29657385,5.3
Christopher Columbus: The Discovery,1992,40000000,8251071,48251071,4.3
Top Dog,1995,6000000,5093707,11093707,4.3
The Pebble and the Penguin,1995,28000000,3983912,31983912,5.2
Sunday,1997,450,288,738,6.3
The Wounds,1998,10000,150000,160000,7.2
The Nutcracker,1993,19000000,2119994,21119994,5.6
Deadfall,1993,10000000,18,10000018,3.1
Love's Deadly Triangle: The Texas Cadet Murder,1997,14000000,161001698,175001698,5
Class of 1999,1990,5200000,2459895,7659895,6.3
The Immortals,1995,50,83,133,7.8
Out on a Limb,1992,11000000,1659542,12659542,6.1
The First Power,1990,10000000,22424195,32424195,4.7
Highway to Hell,1991,9000000,26055,9026055,6.1
Sankofa,1993,1000000,2691899,3691899,6.9
La vérité si je mens !,1997,4000000,29456000,33456000,6.3
"Ryaba, My Chicken",1994,2700000,4635143,7335143,4.3
Falling From Grace,1992,3,232,235,5.3
Rangeela,1995,2800000,14000000,16800000,7.1
Godfather,1991,18000,700000,718000,6.9
Dil To Pagal Hai,1997,1300000,11000000,12300000,6.6
The Last Breath,1999,3800000,559298,4359298,4
The Perfect Weapon,1991,10000000,14061361,24061361,6
Vaali,1999,500000,500000,1000000,6
Amarkalam,1999,500000,500000,1000000,6.6
Aasai,1995,500000,500000,1000000,6
Kadhal Kottai,1996,500000,500000,1000000,7
Paws,1997,137731,1778391,1916122,3.9
The Cherry Orchard,1999,5,135,140,0
Mudhalvan,1999,7400000,22000000,29400000,6.3
